26 14
..........................
..........................
..........................
..........................
..........................
.....#...#################
..........................
###.......................
####......................
########..###.............
...............##.........
.....................#####
..........................
##########################
